18X18 de12 dw14 dn13 h1,13 G7,9 G3,4 m17,5 g1,1
18X18 de14 dw13 ds4 g17,3 M2,2 m16,6 p1,1
18X18 de4 dw9 m1,1 g1,2 g2,1 g2,2 m1,14
18X18 de4 dw9 dn6 G3,8 W14,4 p9,10 M12,11 p1,1
18X18 ds4 G8,9 g6,2 p17,21 M5,5 p9,3 a1,1
18X18 de8 G6,6 z12,1 p6,6 M12,16 w7,6 M2,1
